NO ./textures/comb1/tatame_north_texture.xpm
SO ./textures/comb1/tatame_south_texture.xpm
EA ./textures/comb1/tatame_east_texture.xpm
WE ./textures/comb1/tatame_west_texture.xpm

F 0,0,0 
C  0,0,0

111111111111111111111111111111111
1  110000111000001110000000000011
1 1100100000011100000111001111001
11100111D111111001111110000001001
1100111001    11D1     1001101001
100000011111111000111111001101001
10111000000D0000S0D00000000000001
101000000111111000111111001101011
1011100101    10001    1010100111
1010001101111111001111110010011 1
101110110000100010D01000000011 11
10000000011000010010000100001 101
111111111111111111111111111111111
