



NO ./textures/comb1/tatame_north_texture.xpm
SO ./textures/comb1/tatame_south_texture.xpm
EA	./textures/comb1/tatame_east_texture.xpm
WE	./textures/comb1/tatame_west_texture.xpm        

F 33,47,22 
C  0,250,125

111111111111111111111111111111111
1  110000111000001110000000000011
1 1100100000011100000111001111001
111001110111111111111111100001001
1100111001    1001     1001111001
100000011111111001111111001111001
101110000000000000000000000000001
101000000111111001111111001000011
1011100101    1001     1010100111
1010001101111110001111110010011 1
101110100000100010001000000011 11
1000000000010001000S000100001 101
111111111111111111111111111111111
