NO ./textures/comb1/tatame_west_texture.xpm
SO ./textures/comb1/tatame_west_texture.xpm
EA ./textures/comb1/tatame_west_texture.xpm
WE ./textures/comb1/tatame_west_texture.xpm

F 0,0,0 
C 0,0,0

 111111111111111111111111111111111                 1111111111111111111111111111111111111
 1  110000111000001110000000000011111111111111111111111000000000000011111111111000011
 1 1100100000011100000111001111001111111111111111111111111000000111011110000001100100111
 11100111D111111001111110000001001                  10000001000011001110001D101111100111
 1100111001    11D1     1001101001                  10000000000000000000000000000000000011111
 1000000111111110001111110011010011111111111111111111000000000001110000000000000110000000001
 10111000000000D000D0000000000000000000D000000000000D00000000001   1000000000001  1000000001
 1010000001111110001111110011010111111111111111111111000000000001111000000000000110000000001
 1011100101    10001    1010100111                  1000S000010000000001000011111011110111101
 1010001101111111001111110010011 1                  1111D111D11100001100000011101111111110111
 101110110000100010D01000000011 11                  10000110011000010111001D10001111111001
 10000000011000010010000100001 101                   1110100001100000011001000001111000001
 111111111111000011111111111111111    1111111111      111111111111000000000111111111111111
             1001                     1000000001                 1111000001111111
             1D11                    10000000001                 1111000000000111
             10001111111111111111111110000000001                11110000100001101
             10000000000000000001  1000000000001                   11001000001001
             10000001111000001001111000001100001111111              11D10000000111 
              100100000000011110000000111  100000000011111111111111110000001111111  
              10010000000001111000000000111111000100000000000000000000000001   111
              11111110000110000011111000000000000000001000000000000100000001   1111111
              1111111111D100100000000001111111100111110111111000011 11110001
              11111111111111111111111111111111111111111     1111111111110011
                                                                        11
