NO ./textures/comb1/tatame_north_texture.xpm
SO ./textures/comb1/tatame_south_texture.xpm
EA ./textures/comb1/tatame_east_texture.xpm
WE ./textures/comb1/tatame_west_texture.xpm

F 49,45,21
C  135,206,225

111111111111111111111111111111111
1  110000111000001110000000000011
1 1100100000011100000111001111001
111001110111111001111110000001001
1100111001    1101     1101101001
100000011111111000111111001101001
101110000000000000000010000000001
101000000111111000111111101101011
1011100101    10001    1010100111
1010001101111111001111110010011 1
101110110000100010001000000011 11
10000000011000010010000100001 101
111111111111111111111111111111111
